11
w w w w w w w w w w w
w 1 r x x x x x r 2 w
w r w x w x w x w r w
w r x x x r x x x r w
w r w x w y w x w r w
w r r r r r r r r r w
w r w x w y w x w r w
w x x x x r x x x r w
w x w x w x w x w r w
w x x x x x x x r 3 w
w w w w w w w w w w w