5
w w w w w
w 1 2 r w
w r r r w
w r r 3 w
w w w w w